7 7 7 9 10 7 7 7 7 7 7 7 9 10 7 7 7 7 7 9 
7 7 7 7 7 7 7 7 9 10 7 7 7 7 7 7 9 10 7 7 
9 10 7 7 7 7 7 7 7 7 7 7 9 10 7 7 7 7 7 9 
8 8 8 8 8 8 8 8 8 8 8 8 8 8 8 8 8 8 8 8 
24 14 14 14 14 14 14 14 14 14 14 14 14 14 14 14 14 14 14 26 
24 14 14 14 14 14 14 14 14 14 14 14 14 14 14 14 14 14 14 26 
24 14 14 14 14 14 14 14 14 14 14 14 14 14 14 14 14 14 14 26 
16 21 21 21 21 21 21 21 21 21 21 21 21 21 21 21 21 21 21 13 
24 14 14 14 14 14 14 14 14 14 14 14 14 14 14 14 14 14 14 26 
24 14 14 14 14 14 14 14 14 14 14 14 14 14 14 14 14 14 14 26 
24 14 14 14 14 14 14 14 14 14 14 14 14 14 14 14 14 14 14 26 
24 14 14 14 14 14 14 14 14 14 14 14 14 14 14 14 14 14 14 26 
24 14 14 14 14 14 14 14 14 14 14 14 14 14 14 14 14 14 14 26 
24 14 14 14 14 14 14 14 14 14 14 14 14 14 14 14 14 14 14 26 
24 14 14 14 14 14 14 14 14 14 14 14 14 14 14 14 14 14 14 26 
25 30 30 30 30 30 30 30 30 30 30 30 30 30 30 30 30 30 30 27 
