28 28 28 28 28 28 28 28 28 28 28 28 28 28 28 28 28 28 28 29 
24 14 14 11 17 11 11 11 11 11 11 11 11 11 11 11 11 14 14 26 
24 12 14 11 11 11 11 11 11 11 11 11 11 11 11 11 11 14 14 26
24 14 14 31 11 11 11 11 11 11 11 11 11 11 11 11 31 14 14 26 
24 14 14 11 11 11 11 11 11 11 11 11 11 11 32 11 11 14 14 26 
24 14 14 11 17 11 11 11 11 11 11 11 11 11 11 11 11 14 14 26
24 14 14 11 11 11 11 11 11 11 11 11 11 11 11 11 11 14 14 26 
24 14 14 11 11 11 11 11 11 11 11 11 11 11 11 11 11 14 14 26 
24 14 14 11 11 11 11 11 11 32 11 11 11 11 11 11 31 14 14 26 
24 14 14 11 11 11 11 11 11 11 11 11 11 11 11 11 11 14 14 26 
24 14 14 11 11 11 11 11 11 11 11 11 11 11 11 11 11 14 14 26 
24 14 14 11 33 11 11 11 11 11 11 11 33 11 11 11 11 14 14 26 
24 14 14 11 11 11 11 11 11 11 11 11 11 11 11 11 11 14 12 26 
24 14 14 11 11 32 11 11 11 11 11 11 11 11 11 17 11 14 14 26 
24 14 14 31 11 11 11 11 11 11 11 11 11 11 11 11 31 14 14 26 
25 30 30 30 30 30 30 30 30 30 30 30 30 30 30 30 30 30 30 27 
