19 23 23 23 23 23 23 23 23 23 23 23 23 23 23 23 23 23 23 18 
24 23 14 11 17 11 11 11 11 11 11 11 11 11 11 11 11 14 23 26 
24 23 12 11 11 11 11 11 11 11 11 11 11 11 11 11 11 14 23 26
24 23 14 31 11 11 11 11 11 11 11 11 11 11 11 11 31 14 23 26 
24 23 14 11 11 11 11 11 11 11 11 11 11 11 32 11 11 14 23 26 
24 23 14 11 17 11 11 11 11 11 11 11 11 11 11 11 11 14 23 26
24 23 14 11 11 11 11 11 11 11 11 11 11 11 11 11 11 14 23 26 
24 23 14 11 11 11 11 11 11 11 11 11 11 11 11 11 11 14 23 26 
24 23 14 11 11 11 11 11 11 32 11 11 11 11 11 11 31 14 23 26 
24 23 14 11 11 11 11 11 11 11 11 11 11 11 11 11 11 14 23 26 
24 23 14 11 11 11 11 11 11 11 11 11 11 11 11 11 11 14 23 26 
24 23 14 11 33 11 11 11 11 11 11 11 33 11 11 11 11 14 23 26 
24 23 14 11 11 11 11 11 11 11 11 11 11 11 11 11 11 12 23 26 
24 23 14 11 11 32 11 11 11 11 11 11 11 11 11 17 11 14 23 26 
24 23 14 31 11 11 11 11 11 11 11 11 11 11 11 11 31 14 23 26 
20 23 23 23 23 23 23 23 23 23 23 23 23 23 23 23 23 23 23 22 
