28 28 28 28 28 28 28 28 28 28 28 28 28 28 28 28 28 28 28 29 
24 14 35 1  1  1  1  1  1  1  1  1  1  1  1  1  0  0  14 26 
24 12 35 2  34 34 34 34 34 3  34 34 34 34 34 34 2  0  14 26 
24 14 35 34 34 34 34 34 34 34 34 34 34 34 34 34 34 0  14 26 
24 14 35 34 34 34 34 34 34 34 34 34 34 34 34 34 34 0  14 26 
24 14 35 34 34 34 34 34 34 34 34 34 34 34 34 34 34 0  14 26 
24 14 35 34 34 34 34 3  34 34 34 34 34 34 34 34 34 0  14 26 
24 14 35 34 34 34 34 34 34 34 34 34 34 34 34 34 34 0  14 26 
24 14 35 34 34 4  34 34 34 34 34 34 34 34 34 34 34 0  14 26 
24 14 35 34 34 34 34 34 34 34 34 34 34 34 34 34 34 0  14 26 
24 14 35 34 34 34 34 34 34 34 34 34 34 3  34 34 34 0  14 26 
24 14 35 34 34 34 34 34 34 34 34 34 34 34 34 34 34 0  14 26 
24 14 35 34 34 34 34 34 34 34 34 34 34 2  34 34 34 0  12 26 
24 14 35 4  34 2  34 34 34 34 34 34 34 34 34 34 4  0  14 26 
24 14 35 1  1  1  1  1  1  1  1  1  1  1  1  1  1  0  14 26 
25 30 30 30 30 30 30 30 30 30 30 30 30 30 30 30 30 30 30 27 
